28 31
0 0
02 11 11 11 11 11 11 11 11 11 11 11 11 44 43 11 11 11 11 11 11 11 11 11 11 11 11 01 
04 00 00 00 00 00 00 00 00 00 00 00 00 26 25 00 00 00 00 00 00 00 00 00 00 00 00 03 
04 00 24 15 15 39 00 24 15 16 16 23 00 26 25 00 24 15 15 15 23 00 24 15 15 23 00 03 
04 00 26 00 00 25 00 26 00 00 00 25 00 26 25 00 26 00 00 00 25 00 26 00 00 25 00 03 
04 00 42 21 21 27 00 42 21 21 21 27 00 28 27 00 28 22 22 22 27 00 28 22 22 27 00 03 
04 00 00 00 00 00 00 00 00 00 00 00 00 00 00 00 00 00 00 00 00 00 00 00 00 00 00 03 
04 00 24 15 15 23 00 40 39 00 24 15 15 15 15 15 15 23 00 24 23 00 24 15 15 23 00 03 
04 00 28 21 21 27 00 26 25 00 28 21 21 36 35 21 21 27 00 26 25 00 28 22 22 27 00 03 
04 00 00 00 00 00 00 26 25 00 00 00 00 26 25 00 00 00 00 26 25 00 00 00 00 00 00 03 
06 13 13 13 13 23 00 26 37 15 15 23 00 26 25 00 24 16 15 38 25 00 24 13 13 13 13 05 
00 00 00 00 00 04 00 26 35 21 21 27 00 28 27 00 42 22 22 36 25 00 03 00 00 00 00 00 
00 00 00 00 00 04 00 26 25 00 00 00 00 00 00 00 00 00 00 26 25 00 03 00 00 00 00 00 
45 45 45 45 45 04 00 26 25 00 30 14 34 47 47 33 14 29 00 26 25 00 03 00 00 00 00 00 
12 12 12 12 12 27 00 42 27 00 03 00 00 00 00 00 00 04 00 28 27 00 28 11 11 11 11 11 
45 45 45 45 45 45 00 00 00 00 03 00 00 00 00 00 00 04 00 00 00 00 00 00 00 00 00 00 
13 13 13 13 13 23 00 40 39 00 03 00 00 00 00 00 00 04 00 24 39 00 24 13 13 13 13 13 
00 00 00 00 00 04 00 26 25 00 32 12 12 12 12 12 12 31 00 26 25 00 03 00 00 00 00 00 
00 00 00 00 00 04 00 26 25 00 00 00 00 00 00 00 00 00 00 26 25 00 03 00 00 00 00 00 
45 45 45 45 45 04 00 26 25 00 24 15 15 15 15 15 15 23 00 26 25 00 03 00 00 00 00 00 
02 11 11 11 11 27 00 42 27 00 28 21 21 36 35 21 21 27 00 28 27 00 28 12 12 12 12 01 
04 00 00 00 45 45 00 00 00 00 00 00 00 26 25 00 00 00 00 00 00 00 00 00 00 00 00 03 
04 00 40 15 15 23 00 24 15 15 15 23 00 26 25 00 24 15 15 15 23 00 24 15 15 23 00 03 
04 00 28 21 36 25 00 28 22 22 22 27 00 28 27 00 28 22 22 22 27 00 26 35 22 27 00 03 
04 00 00 00 26 25 00 00 00 00 00 00 00 00 00 00 00 00 00 00 45 00 26 25 00 00 00 03 
08 15 39 00 26 25 00 24 23 00 24 15 15 15 15 15 15 39 00 24 23 00 26 25 00 24 15 07 
10 22 27 00 28 27 00 26 25 00 28 22 22 36 35 22 22 27 00 26 25 00 28 27 00 28 21 09 
04 00 00 00 00 00 00 26 25 00 00 00 00 26 25 00 00 00 00 26 25 00 00 00 00 00 00 03 
04 00 24 15 15 15 15 38 37 16 16 23 00 26 25 00 00 24 16 38 37 16 16 16 16 23 00 03 
04 00 28 21 21 21 21 21 21 21 21 27 00 28 27 00 00 28 21 21 21 21 21 21 21 27 00 03 
04 00 00 00 00 00 00 00 00 00 00 00 00 00 00 00 00 00 00 00 00 00 00 00 00 00 00 03 
06 13 13 13 13 13 13 13 13 13 13 13 13 13 13 13 13 13 13 13 13 13 13 13 13 13 13 05